NO ./textures/no.xpm
EA ./textures/ea.xpm
SO ./textures/so.xpm
WE ./textures/we.xpm
F 98, 101, 103
C 23, 32, 42
11111111111111111111111111111111111111111111111111111111111
10000000000001000000000000000000000000000000000000000000001
10000000000001000000000000001000000000000000000000000000001
10000000000011100000000000000000000000000000000000000000001
10000000000000000000000000000000000000000000000000000000001
10000010100000000000000000000000000000000000000000000000001
10000010100000000000100000001000000000000000000000000000001
10000010100000000000000000000000000000000000000111111111111
100000101000000000000000000000000000000000000001111111111111111111111111
1000010010000N0000000000000000000000000000000000000000000000000000000001
100001001000010000000000000010000000000000000001111111111111111111111111
100000000000000000000000000000000000000000000001
10000000000000000000000000001000000000000000000111111111111
11111111111111111111111111111111111110000000000000000000001
10000000000001000000000000001000000000000000000000000000001
10000000000011100000000000000000000000000000000000000000001
10000000000000000000000000000000000000000000000000000000001
10000010100000000000000000000000000000000000000000000000001
10000010100000000000100000000000000000000000000000000000001
10000000000001000000000000000000000000000000000000000000001
10000000000011100000000000000000000000000000000000000000001
10000000000000000000000000000000000000000000000000000000001
10000010100000000000000000000000000000000000000000000000001
10000010100000000000100000000000000000000000000000000000001
10000000000001000000000000000000000000000000000000000000001
10000010100000000000000000000000000000000000000000000000001
11111111111111111111111111111111111111111111111111111111111