NO ./textures/no.xpm
EA ./textures/ea.xpm
SO ./textures/so.xpm
WE ./textures/we.xpm
F 203,0,255
C 1,2,0
1111111111111111111111111111
1000000000000100000000000001
1000000000000100000000000001
1000000000001110000000000001
1000000000000000000000000001
1000001010000000000000000001
1000001010000000000010000001
1000001010000000000010000001
1000001010000000000000000001
1000010010000N00000000000001
1000010010000100000000000001
1000000000000000000000000001
1000000000000000000000000001
1111111111111111111111111111