NO ./textures/no.xpm
SO ./textures/so.xpm
WE ./textures/we.xpm
EA ./textures/ea.xpm

F 48,59,76
C 77,159,240


11111111111111111111111111111111111111111111111111111111111111111111111
10000000000001000000000000000000000000000000000000000000000000000000001
10000000000001000000000000001000000000000000000000000000000000000000001
10000000000011100000000000000000000000000000000000000000000000000000001
10000000000000000000000000000000000000000000000000000000000000000000001
10000010100000000000000000000000000000000000000000000000000000000000001
10000010100000000000100000001000000000000000000000000000000000000000001
10000010100000000000000000000000000000000000000000000000000111111111111
100000101000000000000000000000000000000000000000000000000000000000S0001
10000100100000000000000000000000000000000000000000000000000000000000001
10000100100001000000000000001000000000000000000000000000000111111111111
10000000000000000000000000000000000000000000000000000000000000000000001
10000000000000000000000000001000000000000000000000000000000000000000001
11111111111111111111111111111111111110000000000000000000000000000000001
10000000000001000000000000001000000000000000000000000000000000000000001
10000000000011100000000000000000000000000000000000000000000000000000001
10000000000000000000000000000000000000000000000000000000000000000000001
10000010100000000000000000000000000000000000000000000000000000000000001
10000010100000000000100000000000000000000000000000000000000000000000001
10000000000001000000000000000000000000000000000000000000000000000000001
10000000000011100000000000000000000000000000000000000000000000000000001
10000000000000000000000000000000000000000000000000000000000000000000001
10000010100000000000000000000000000000000000000000000000000000000000001
10000010100000000000100000000000000000000000000000000000000000000000001
10000000000001000000000000000000000000000000000000000000000000000000001
10000010100000000000000000000000000000000000000000000000000000000000001
11111111111111111111111111111111111111111111111111111111111111111111111