NO ./textures/no.xpm
SO ./textures/so.xpm
WE ./textures/we.xpm
EA ./textures/ea.xpm

F 84,153,199
C 1,1,1


111111111111111111111111111111111111111111111111111111111111111111111111111111111111111111
100000000010000000000000000000000000000010001000000000000000000000000000000000000000000001
10000N000010000011111111111111111100000001001000000000000000000000000000000000000000000001
100000000010000100000000000000000010000010001000001111111111111111111111111111111111100001
100000000010001000000000000000000001000001001000001000000000000000000000000000000000100001
100000000010010000000000000000000001000010001000001000000000000000000000000000000011000011
100000000010011111111111000000000001000001001000001000000011111111111100000000001100000101
100000000010000000000001000000000001000010001000001000000100000000000100000000011000001001
100000000011111111110001000000000001000001001000001000000100111111100100000000000000010001
100000000010000000000001000000000001000010001000001000000100100000100100000000000000100001
100000000010010000000001000000000001000001001000001000000100100000100111111111111111001111
100000000010000011111110000000000001000010001000001000000100100000000000000000000000000001
100000000010010100000000000000000001000001001000001000000100100000100111111111111111111101
100000000010000100000000000000000001000010001000001000000100100000100100000000000000000001
100000000010010100000000000000000001000001001000001000000100010000100100000000000000000001
100000000010000100000000000000000001000010001000001000000100010000100100000000000000000001
100000000010010100000000000000000001000001001000001000001100000000100100000000000000000001
100000000010000100001111111111111100000010110000001000010000000000100100000000000000000001
100000000010010100100000000000000000000001100000011110010100000000100100000000000000000001
100000000010000101000111111111111111111110000001110000010111111110000100000000000000000001
100000000010010100100000001000000000000000001110000000010100000011111111110001111111111101
100000000010000100011111001001111111111111110000000000010100001010000000001001000000000001
100000000010010100000001001001000000000000000000000000010100001010000100001111011111111101
100000000010000100000001001001000000000000000000000000101010001010000100000001010000000101
100000000010010100000001001001000000000010000000000000010000000010000100001001010000000101
100000000010000100000001001001000000000000000000000000100011001010000100001001010000000101
100000000010010100000001001001000000000000000000000001111011111010000100001001010000000101
100000000010000100000001001001000000001111111111111110000000000000000000000000010000000101
100000000010010100000001001001000000000110000000000000011111111111111111111111110000000101
100000000010000100000001001001000000000010111111111111110000000000000000000000000000000101
100000000010010100000001001001000000000000100000000000000000000000000000000000000000000101
100000000010000010000001001001000000000011111111000000000000000000000000000000000000000101
100000000010010001000001001001000000000000000001000000000000000000000000000000000000000101
100000000010000000100001001001000000000011110001000000000000000000000000000000000000000101
100000000010010000010001001001000000000000100001000000000000000000000000111111111111111101
100000000010000000001001001001000000000010010001111111111111111111111111000000000000000001
100000000010010000000101001001000000000000010000000000000000000010000000111100000000000111
100000000010000000000101001001000000000010010000000100000000000000000000000010000000000001
100000000010010000000101001001000000000000011111111111111111111011111111111011111110000001
100000000010000000000101001001000000000010000000000000000000000000000000000000000110000001
100000000001111100000101001001000000000001111111111111111111111111111111111111110110000001
100000000000000000000101001001000000000010000000001000010000100010001000100000000010000001
100000000000000000000101001001000000000000000000100010000100001000100010000101000010000001
100000000000000000000101001001000000000011111111111111111111111111111111111101111111000001
100000000000010000000101100010000000000000000000000000000000000000000000000000000001000001
111111111111111111111111111111111111111111111111111111111111111111111111111111111111000001
100000000000010000000000000000000000000000000000000000000000000000000000000000000000000001
100000000000010000000000000000000000000000000000000000000000000000000000000000000000000001
100000000000010000000000000000000000000000000000000000000000000000000000000000000000000001
100000000000010000000000000000000000000000000000000000000000000000000000000000000000000001
100000000000010000000000000000000000000000000000000000000000000000000000000000000000000001
100000000000000000000000000000000000000000000000000000000000000000000000000000000000000001
100000000000010000000000000000000000000000000000000000000000000000000000000000000000000001
100000000000010000000000000000000000000000000000000000000000000000000000000000000000000001
100000000000010000000000000000000000000000000000000000000000000000000000000000000000000001
100000000000010000000000000000000000000000000000000000000000000000000000000000000000000001
100000000000010000000000000000000000000000000000000000000000000000000000000000000000000001
100000000000010000000000000000000000000000000000000000000000000000000000000000000000000001
100000000000010000000000000000000000000000000000000000000000000000000000000000000000000001
100000000000010000000000000000000000000000000000000000000000000000000000000000000000000001
100000000000010000000000000000000000000000000000000000000000000000000000000000000000000001
100000000000010000000000000000000000000000000000000000000000000000000000000000000000000001
100000000000010000000000000000000000000000000000000000000000000000000000000000000000000001
100000000000010000000000000000000000000000000000000000000000000000000000000000000000000001
100000000000010000000000000000000000000000000000000000000000000000000000000000000000000001
100000000000010000000000000000000000000000000000000000000000000000000000000000000000000001
100000000000010000000000000000000000000000000000000000000000000000000000000000000000000001
100000000000000000000000000000000000000000000000000000000000000000000000000000000000000001
100000000000010000000000000000000000000000000000000000000000000000000000000000000000000001
100000000000010000000000000000000000000000000000000000000000000000000000000000000000000001
100000000000010000000000000000000000000000000000000000000000000000000000000000000000000001
100000000000010000000000000000000000000000000000000000000000000000000000000000000000000001
100000000000010000000000000000000000000000000000000000000000000000000000000000000000000001
100000000000010000000000000000000000000000000000000000000000000000000000000000000000000001
100000000000010000000000000000000000000000000000000000000000000000000000000000000000000001
100000000000010000000000000000000000000000000000000000000000000000000000000000000000000001
100000000000010000000000000000000000000000000000000000000000000000000000000000000000000001
100000000000010000000000000000000000000000000000000000000000000000000000000000000000000001
100000000000010000000000000000000000000000000000000000000000000000000000000000000000000001
100000000000010000000000000000000000000000000000000000000000000000000000000000000000000001
100000000000010000000000000000000000000000000000000000000000000000000000000000000000000001
100000000000000000000000000000000000000000000000000000000000000000000000000000000000000001
100000000000010000000000000000000000000000000000000000000000000000000000000000000000000001
100000000000010000000000000000000000000000000000000000000000000000000000000000000000000001
100000000000010000000000000000000000000000000000000000000000000000000000000000000000000001
100000000000010000000000000000000000000000000000000000000000000000000000000000000000000001
100000000000010000000000000000000000000000000000000000000000000000000000000000000000000001
100000000000010000000000000000000000000000000000000000000000000000000000000000000000000001
100000000000010000000000000000000000000000000000000000000000000000000000000000000000000001
100000000000010000000000000000000000000000000000000000000000000000000000000000000000000001
100000000000010000000000000000000000000000000000000000000000000000000000000000000000000001
100000000000010000000000000000000000000000000000000000000000000000000000000000000000000001
100000000000010000000000000000000000000000000000000000000000000000000000000000000000000001
100000000000010000000000000000000000000000000000000000000000000000000000000000000000000001
111111111111111111111111111111111111111111111111111111111111111111111111111111111111111111












