NO ./textures/no.xpm
SO ./textures/so.xpm
WE ./textures/we.xpm
EA ./textures/ea.xpm

F 84,153,199
C 255,1,255

111111111111111111111111111111111111111111111111111111111111111111111111111111111111111111
1000000000S0000000000000000000000000000010000000000000000000000000000000000000000000000001
100000000000000000000000000000000000000000000000000000000000000000000000000000000000000001
100000000000000000000000000000000000000000000000011111111111111111111111100000000000000001
100000000000000000000000000000000000000000000000010000000000000000000000100000000000000001
100000000101000000000000000000000000000010000000010111111111111111111110100000000000000001
100000000101000000000000000000000000000000000000010100000000000000000010100000000000000001
100000000101000000000000000000000000000010000000010100000000000000000010100000000000000001
100000000101000000000000000000000000000000000000010100000000000000000010100000000000000001
100000000101000000000000000000000000000010000000010100000000000000000010100000000000000001
100000000101000000000000000000000000000000000000010100000000000000000010100000000000000001
100000000101000000000000000000000000000010000000010100000000000000000010100000000000000001
100000000101010000000000000000000000000000000000010100000000000000000010100000000000000001
100000000101000000000000000000000000000010000000010100000000000000000010100000000000000001
100000000101010000000000000000000000000000000000010100000000000000000010100000000000000001
100000000101000000000000000000000000000010000000010111111111111111111110100000000000000001
100000000101010000000000000000000000000000000000010000000000000000000000100000000000000001
100000000101000000000000000000000000000010000000010111111111111111111111010000000000000001
100000000101010000000000000000000000000000000000010100000000000000000010100000000000000001
100000000101000000000000000000000000000010000000010100000000000000000010100000000000000001
100000000101010000000000000000000000000000000000010100000000000000000010100000000000000001
100000000101111111111111111111111111111111111111100100000000000000000010100000000000000001
100000000100000000000000000000000000000000000000000100000000000000000000100000000000000001
100000000111111111111111111111111111111111111111111111111111111111111111100000000000000001
100000000000010000000000000000000000000000000000000000000000000000000000000000000000000001
100000000000000000000000000000000000000010000000000000000000000000000000000000000000000001
100000000000010000000000000000000000000000000000000000000000000000000000000000000000000001
100000000000010000000000000000000000000000000000000000000000000000000000000000000000000001
100000000000000000000000000000000000000000000000000000000000000000000000000000000000000001
100000000000010000000000000000000000000000000000000000000000000000000000000000000000000001
100000000000010000000000000000000000000000000000000000000000000000000000000000000000000001
111111111111111111111111111111111111111111111111111111111111111111111111111111111111111111