NO ./textures/no.xpm
SO ./textures/redbrick.xpm
WE ./textures/we.xpm
EA ./textures/ea.xpm

F 98,70,33
C 77,159,240

1111111111111111111111111111111111
1000001000000100000000000001001111
1110101111110101111111111111111111
1000100000000101000000000001111111
101111111111110001111111110011E001
1000000000000001000000001101111101
1011111111111100011111101101001101
1000000000000000000000000000000001
1111111111111111111111111111111111
